Role	Company	Location	Date
Data Scientist	 MBN Solutions	Glasgow, United Kingdom1 connectionApplied: 7 days ago	 7 days ago
Python Developer	 Franklin Bates Ltd	London, United KingdomApplied: 1 month ago	 1 month ago
Junior/Mid-level Systems Engineer/DevOps role - Award winning Trading firm - £110,000 with exceptional bonus and package - Central London	 Hunter Bond	London, United KingdomApplied: 1 month ago	 1 month ago
Junior Data Analyst	 MThree Consulting	London, United KingdomApplied: 1 month ago	 1 month ago
Junior Data Analyst Consultant	 Bodhi Resourcing	London, England, United KingdomApplied: 1 month ago	 1 month ago
Automation Tester	 Rebel Recruiters	Castle Donington, Derbyshire, United KingdomApplied: 1 month ago	 1 month ago
Data Scientist - AI Specialist	 MBN Solutions	London, United Kingdom1 connectionApplied: 1 month ago	 1 month ago
Junior Python Developer	 Data Ninjas	London, England, United KingdomApplied: 1 month ago	 1 month ago
Analyst (Digital / Social)	 Weber Shandwick	London, England, United KingdomApplied: 1 month ago	 1 month ago
Operations Analyst	 36 South Capital Advisors	London, United KingdomApplied: 1 month ago	 1 month ago
SEO Manager	 iProspect	Newcastle upon Tyne, United KingdomApplied: 1 month ago	 1 month ago
Junior Software Engineer	 GSR	London, United KingdomApplied: 1 month ago	 1 month ago
Junior Data Scientist	 Campion Pickworth Ltd	London, United KingdomApplied: 1 month ago	 1 month ago
PAID Junior Devops AWS/Azure/GCP Kubernetes Engineer	 Kubix.io - Enterprise Cloud DevOps Consultancy	London, United KingdomApplied: 1 month ago	 1 month ago
Deep learning Engineer	 Costello & Reyes Limited	London, United KingdomApplied: 1 month ago	 1 month ago
Junior Analytic Scientist	 FICO	Solihull, England, United KingdomApplied: 1 month ago	 1 month ago
Junior Python/Pipeline Developer	 Saddington Baynes	London, United KingdomApplied: 1 month ago	 1 month ago
Junior Application Developer	 Partners in Performance	Reading, England, United KingdomApplied: 1 month ago	 1 month ago
Python Developer (Distributed Systems)	 Augmentti	London, United KingdomApplied: 1 month agoApplication seen: 1 month ago	 1 month agoApplication seen: 1 month ago
Data Analyst - Senior Consultant	 Iceberg (Cyber Security)	London, England, United KingdomApplied: 1 month ago	 1 month ago
Data Scientist - £45,000	 Goodman Masson	Brighton, United KingdomApplied: 1 month ago	 1 month ago
Junior Software Developer	 Magellan Robotech	Liverpool, Merseyside, United KingdomApplied: 1 month ago	 1 month ago
Graduate Software Development Engineer	 Opus Resourcing Ltd	Reading, England, United KingdomApplied: 1 month ago	 1 month ago
Junior/Mid level Data Scientist	 Big Cloud	London, United KingdomApplied: 1 month ago	 1 month ago
Javascript + Node.js + React.js - JUNIOR DEVELOPER - an amazing opportunity for your second job...! Junior Web Developer | Junior Full Stack Developer | Javascript Developer | Software Developer	 Tehk Recruitment Ltd	London, England, United KingdomApplied: 1 month ago	 1 month ago
DevOps Engineer	 Talent Cluster Ltd	Oxford, United KingdomApplied: 1 month ago	 1 month ago
Penetration Tester / Red Team Consultant (UK wide/home based)	 Raytheon UK	London, United KingdomApplied: 4 months ago	 4 months ago
Data Scientist	 Prognostic	Cambridge, United KingdomApplied: 4 months ago	 4 months ago
Analyst / Developer	 James Andrews Recruitment Solutions Ltd	Milton Keynes, England, United KingdomApplied: 4 months ago	 4 months ago
Project Manager	 iOpener Institute for People and Performance	Oxford, United KingdomApplied: 4 months ago	 4 months ago
Integrated Project Manager	 Williams Lea Tag	London, England, United Kingdom1 alumApplied: 4 months ago	 4 months ago
Data Analyst	 Hummingbird Technologies Ltd	London, United KingdomApplied: 9 months ago	 9 months ago
Data Scientist / Analyst	 dunnhumby	London, United KingdomApplied: 10 months ago	 10 months ago
Business Improvement Manager	 Airwave	Rugby, Warwickshire, United KingdomApplied: 10 months ago	 10 months ago
Customer Success Manager	 TIBCO	London, United KingdomApplied: 10 months ago	 10 months ago
Internal Account Manager/Customer Sucess Executive	 GBG Plc	Worcester, United KingdomApplied: 10 months ago	 10 months ago
Customer Success Executive - HR Software	 Appogee HR Limited	Reading, United KingdomApplied: 10 months ago	 10 months ago
Senior Customer Success Manager @ International Social Tech Platform	 Grey Matter Recruitment	London, United KingdomApplied: 10 months ago	 10 months ago
Digital Project Manager - London Agency - £35k+	 Profiles Creative	London, United KingdomApplied: 10 months ago	 10 months ago
Customer Success Manager	 Saleslogic	London, United KingdomApplied: 10 months ago	 10 months ago
Marketing and Creative Coordinator	 The Athenian	London, United KingdomApplied: 10 months ago	 10 months ago
Data Analyst	 Tutti Bambini	London, Greater London, United KingdomApplied: 11 months ago	 11 months ago
Customer Success Executive (Social Media)	 Onalytica	London, Greater London, United KingdomApplied: 11 months ago	 11 months ago
Customer Success Assistant	 hibob	London, United KingdomApplied: 11 months ago	 11 months ago
